WWWWWWWWWWWWWWWWWWWWWWWWWWWWWWWWWWWWWWWWWWWWWWWWWWWWWWWWWWWWWWWWWWWWWWWWWWWWWWWWWWWWWWWWWWWWWWWWWWWW
WWWWWWLLWLWWWLLLLLLLLLWWWWWWWWWLLLLWWWWWWWWWWWWWWWWLLLLLLLLLWWWWWWWWLLLLLLWWWLLLLLWWWWWWWWWWWWLLLLWW
WWWWWLLLLWWLLLLLLLLLLLWWWWWWWWWLLLLWWWLWWWWWWWWWWWWWWLLLLLLLLLWWWWWWWLLLLLLWWLLLLLWWWWLWWWWWWWWWLLWW
WWWWWLLLLLLLLLLLLLLLLLWWWWWWWWWLLLLWWWWWWWWWWWWWWWWWWWWWWLLLLLWWWWWWWWLLLLLLLLLLLWWWWWWWWLWWWWWWLLLW
WWWWLLLLLLLLLLLWWWLLLLWWWWWWWWWLLLWWWWWLWWWWWWWWWWWWWWWWWWWWWWWWWWWWWWWLLLLLLWLLWLWWWWWWWWWWWWWWLLLW
WWWLLLLLLLLLLLWWWWWWWLWWWWWWWWWWWWWWWWWWWWWWWLWWLWWWWWWWWWWWWWWWWWLWWWWLLLLLWWWWWWWWWWWWWWWWWWWWLLLW
WWWLLLLLLLWLWWWWWWWWWWWWWWWWWWWWWWWLWWWWWWWWWWWWWWWWWWWWWWWWWWWWWWWWWWWWLLLLWWWWWWWWWWWWWWWWWWWWLLLW
WWWWLLLLLLWWWWWLWWWWWWWWWWWWWWWWWWWWWWWWWWWWWWWWLLWWWWWWWWLWWWWLWWWWWWWWWLWWWWWWWWWWWWWWLLLLWWWWWLLW
WWWWWLLLLLWWWWWWWWWWWWWWWWWWWWWWWWWWWWWWWWWWWWWLLLWWWWWWWWWWWWWWWWWWWWWWWWWWWWWWWWWWWWWLLLLLWWWLWWWW
WWWWWLWWLLLWWWWWWWWWWWWWWWWWWLWWWWWWWWWWLWWLWWLLLLWWWWWWWWWWWWWWWWWWWWWWWWWWWWWWWWLLLLLLLLLLWWWWWWWW
WWWWWWWWLLLWWWWWWWWWWWLWWWWLWWWWWWWWWWWWWWWWWWLLLWWWWWWWWWWWWLLLLLWWWLWWWWWWWWWWWWLLLLLLLLLWWWWWWWWW
WWWWWWWLLLWWLWWWWWWWWWLWWWWWWWWWWWWWWWWWWWWWWLLLWWWWWWWWWWWLLLLLLLWWLWWWLWWWWWWWWLLLLWWWWWWWWWWWWWWW
WWWWLLLLLLWWWWWWWWWLWLLLWWWWWWWWWWWWWWWWWWWLLLLLWLWWWWWWWWLLLLLLLLLLWWWWWWWWWWWLWLLLWWWWWWWWWWWWWWWW
WWWLLLLLLWWWWWWWWWWWWWLWWWWWWWLWWWWWLLWWWLLLLLLWWWWWWWWWWWLLLLLLLLLWWWWWWWWWWWWLLLLWWWWWWWWWWWWWWWWW
WWLLLLLLLWWLWWWWWWWWWWWWWWWWWWWWWWWWWWWWLLLLLLLWWWWWWWWWWLLLLLLLLLLWWWWWWWWWWLLLLLWWWWWWWWWWWWWWWWWW
WLLLLLLLLLWWWWWWWWWWWWWWWWWWWWWLWWWWWWWWWLLLLLLWWWWWWLWWWWLLLLLLLLLWWWWWWWWWLLLLLLWWWWWWWWWWWWWWWWWW
WWLLLLLLLLLWWWWWWWWWWWLWWWWWWWWWWWWWWWWWWWWWLLLWWWWWWWWWWWWWWWWLLLLLLWWWWWWWLLLLLLWWWWWWWWWWWWLWWWWW
WWLLLLLLLLLLLLLLLLWWWWWWWWWLLLWWWWWWWWWWWWWWWLLLWWWWWWWWWWWWWWWWWLLLLLLWWWLWWLLLLLWWWWWWWWWWWWWWWWLW
WWWWWWWWLLLLLLLLLWWWWWWWWWLLLLWWWWWWWLLWWWWWWWLLWWWWWWWWWWWWWWWWWLLLLLLWWWWWWWWWWWWWWWWWWWWWWWWLWLLW
WLWWWWWWWLWLLLLLLWWWWWWWWLLLLLWWWWWWWLLWWWWWWWLLWWWWWWWWWWWWWWWWWLLLLLWWWWWLWWWWWWWWWWWWWWWWWWWWWLLW
WWWWWWWWLWWWWWLLLWWWWWWWLLLLLLLWWWWWWLLLWWWWWWLLLWWWWWWWWWWWLWWWWLLLLWWWWWWWWWWWWWWWWWWWWWWWWWWWWWWW
WLWWWWWWWWWWWWLWWWWWWWWWLLLLLLLWWWWWWLLLWWWWLWLLWWWWWWWWWWWWWWWWLLLLWWWWWWWWWLWWWWWWWWWWWWWWWWWWWWWW
WLWWLWWWWWLWWWWWWWWWWWWWWWWLLLLWWWWWWLLLWWLWWWLLLWWWWWWWWWWWWWWWLLLLWWWWWWWWWWWWWWWWWWWLLLLWWWWWWLWW
WLWWWWWWLWWWWWWWWWWWWWWWWWWWLLLLLWWWWLLLWWWWWLLLLLLLWWWWWWWWWWWLLLLLWWWWWWWWWWWWWWWWWWLLLLLLLWWWWWWW
WLWWWWWLWWWWWWWWWWWWWWWWWWWWWLLWWWWWWWLLLWWWLLLLLLLLWWWWWWWWWWWLLLLLWWWWWWWWWWWWWWWLWWWLLLLLLLWWWWLW
WLLWLWWWWWWWWWWWWWLLWWWWWWWWLWWWWWWWWWWLLLLLLLLLLLLWWWWWWWLWWWWLLLLLLWWWWWWWWWWWWWWWWWWWLLLLLLWWLWWW
WLLWWLWWWWWLWWWWWLLLWWWWWWWWWLWWWWWWWWWWWLLLLLLLLLWWWWWWWWWLWWWLLLLLLWWWWWWWWLWWWWWWWWWWWLLLWWWWWWWW
WLLLWWWWLLLWWWWWLLLLLWWWWWWWWWWWWWWWWWWWWLLLLLLLLWWWWWWWWWWWWWWWLLLLLWWWWWWWWWWWLWWLWWWWWWWWWWWWWWWW
WLLLWWWLLLLLLWWLLLLWWWWWWWWWWWWWWWWWWWWWWWLLLLLWWWWWWWWWWWWWWWWWLLLLLWWWWWWWWWWWWWLLLLWWWWWWWWWWWWWW
WWWWWWWLLLLLLLLLLLLWWWWWWWWWWWWWLWWWWWWWWWWWWWWWWWWWWWWWWWWWWWLLLLLLWWWWWWWWWWWWWWLLLLLLWWWWWWWLWWLW
WWWWWWWLLLLLLLLLLWWWWWWWLLLLLWWWWWWWWWWWWLWWWWWWWWWWWWWWWWWWWWLLLLLWWWWWWWWWWWWWWWLLLLLLWWWWWWWWWWLW
WWWWWWWLLLLLLLLLLWWWWWWLLLLLLLWWWWWWWWWWWWWWWWWWWLWWWWWWWWWWWLLLLLWWWWWWWWWWWWWWWWWWWLLLWWWWWWWWWLLW
WWWWWWWLLLLLLLLLLWLWWWWLLLLLLLLLWLWWWWWWWWWWLWWWLLLLWLWWWWWWLLLLLWWWWWWWWWWWWWWWLWWWWWWWWWWWWWWWWLLW
WWWWWWWWLLLLLLLLWWWWWWLLLLLLLLLLLWWWWWWWWWWLLWWLLLLLLLWWWWWLLLLLWWWLWWWLLWWWWWWWWWWWWWWWWWWWWWWLWLLW
WWWWWWWWWLLLLLLLWWWWWWLLLLLLLLWWWLLLLLLWWWLLLWWWLLLLLLLLLLLLLLWWWWLWWWWLLWWWWWWWWWWWWWWWWWWWWWWWWWWW
WWWWWWWWWWWWWWLWWWWWLLLLLLLLWWWWWWLLLLLLLLLLWWWWWLLLLLLLLLLLWWWWWLLWWWWWWWWLWWWWWWWWWWWWWWWWWWWWWWWW
WWWWWWWWWWWWWWWWWWWLLLLLLLLLWWWWWWLLLLLLLLLLWWWWWWLLLLLLLLLLWWWWWWWWWWWWWWWWWWWWWWWWWWWWWWWWWWLWWWWW
WWWWWWWWWLWWWWWWWWLLLLLLLLLLWWLWWWLLLLLLLLLLWWWWWWWLLLLLLLLLWWWWWWWWWWWWWWWLWWLLLLWWWWWWWWWWWWWWWWWW
WWWWWWWWWWWWWWWWWWLLLLLLLLLLWWWWWWLLLLLLLLLLWWWWWWWLLLLLLLLLWWWWWWWWWWWWWWWWWWLLLLLWWWWWWWWWWWWWWWWW
WWWWWWWWWWWWWWWWWWWWLLLLLLLLLWWWWWLLLLLWWWWLWWWWWWWWLLLLLLLWWWLWWWWWWWWWWLLLWWWWLLLWWWWWWWWWWWWWWWWW
WWWWWWWWWWWWWWWWWWWWWWWWLLLLLWWWWWLLLWWWWWWWWWWWWWWWLLLLLLLWWWWWWWWWWWWWWLLLLWWWWWWWWWWWWWWWWWWWWWWW
WWWWWWWWWWWWWWWWWWWWWWWWWLLLLLWWLLLLWWWWWWLWWWWWWWWWWLLLLWWWWWWWWWWWWWWWWLLLWWWWWWWWWWWWWWWWWWWWWWWW
WWWWWWWWLWWWWWWWLWWWLWWWWWLLLLLLLLLWWWWWWLWWWWWWWWWWWWWWWWWWWLWWWWWWLWWLWLLLWWWWWWWWWWWWWWWWWWWWWWWW
WWWWWWLWWWWWWWWWWWWWWWWWWWWLLLLLLLLWWWWWWWWWWLWWLWWWWWWWWWWWWWWWWWWWWWWWWLLLWWLWWWWWWLWWWWWWWWWWLLWW
WWWWWWWWWLWWWWWWWWWWWWWWWWWLLLLLLLWWWWWWWWWWWWWWWWWWWWWWWWWWWWWWWWWWWWWWWLLWWWWWWWWWWWWWWWWWWWWWWWWW
WWWWWWWWWWWWWWWLLWWWWWWWWLWWWLLLWWWWWWWWWWWWWWWWWWWWWWWWWWWWWWWWWLWWWWWWWLWWWWWWWWWWWWWWWWWWWWWWWWWW
WWWWWWWWWWWWWWLLLLLWWWWWWWWWWWWWWWWWWLWWWWWWWWLLLLWWWWWWWWWWWWWWLWWWWWWWWWWWWWWWWWWWWWWWWWWWWWWWWWWW
WWWLWWWWWLWWLWLLLLLLWWWWWWWWWWWWWWWWWWWWWWWWWLLLLLWWWWWWWWWWWWWWWWWWWWWLWWWWWWWWWWWWWWWWWWWWWWWWWWWW
WWWWWWWLWLLWWLLLLLLLWWWWWWWWWWWWWWWLWWLLLWWWWLLLLLLWWWWLLWWWWWWWWWWWWWWWWWWWWWWWWWWWWWWWWWWWWWWWWWWW
WWWLWWWWWWWWWWLLLLLWWWWWWWWWWWWWWWWWWLLWWWWWWLLLLLWWWWWWWWLLLWWWWWWWWWWWWWWWWWWLWWWWWWWWWWWWWWWWWWWW
WWWWWWWWWWWWWWWLLLLWWWWWWWWWWWWWWLLLLWWWWWWWWWLLLWWWWWWWWLLLLWWWWWWWWWWWLLWWWLWWWLWWWWWWWWWWWWWWWWWW
WWWWWLWWWWWWWWWWLWWLWWWWWWWWWWWWWLLLLWWWWWWWWWWWWWWWWWWWWWLLWLWWWWWWWWWWLLWWWWWWWWWWWWWWWWWWWWWWWWWW
WWWWWLLWWWWWWWWWWWWWWWWWWWWWLWWWLLLLLWWWLWWWWWWWWWWWWWWWWWWWWLWWWWLWWWLWWWWWWWWWWWWWLWWWWLLLLWWWWWWW
WWWWWWWWWWWWWWWWWWWWWWWWWWWLWWWWLLLLWWWWWWWWWWWLWWWWWWWWWWWWWWWWWWWWWWWWWWWLWWWWWWWWWWWWLLLLLLLWWWWW
WWWWWWWWWWWWWWWLWWWWWWWWWWWWLWWWLLLLWWWWWWWWWWWWWWWWWWWWWWLWWWWWWWWWWWWWWWWWWWWWWWWWWWLWLLLLLLLWWWWW
WWWLWWWWWWWWWWLLLWWWWWWWWLWWWWWWWLLLWWWWWWWWWWWWWWWWWWWWWWLWWWWWWWWWWLLLWWWWWWWWWWWWWWWWLLLLLLWWWWWW
WWWWWWLWWWWWWLLLLWWWWWWWWWWWWWWWWWWWWWWLWWWWWWWWWWWWWWWWWLWWWWWWWWWWWLLLWWWWWWWWWWWWWWWWLLLLLWWWLWWW
WWWWWWWWWWWWLLLLLWWWWWWWWWWWWWWWWWWWWLWWWWWLLWWWWWWWWWWWWWLWWWWWWWWWLLLLLWWWWWWWWWWWWWLLLLLLWWWLWWWW
WWWWWWWWWWWWLLLLLWWWWWWWWWWWWWWWWWWWLWWWWWWWWLWWWLWWWWWWWWWWWWWWWWLWLLLLLWWWWWWWLLLLLLLLLLLWWWWWWWWW
WWWWWWWWLLLLLLLLLWWWWWWWWWWLWWWWWWWWLLLLWWWWWWWWWWWWWLLWWWWWLWWWWWWWLLLLLWWWWWWWLLLLLLLLLLWWWWWWWWWW
WWWWWWWWLLLLWWWLLLLWWWWWWLWLLWWWWWWWLLLWWWWWWWWWWWWWWLLWWWWWWWWWWWWLWLLLLLWWWWWWWLLLLLLLLWWWWWWWWLWW
WWWWWWWWLLLWWWWWLLLLLWWWWWWLLLWWWWWWLLLLWWWWWWWWWWWWWLLLWWWWWWLWWWWWWLLLLLLWWWWWWLLLLLLLWWWWWWWWWWWW
WWWWWWWWWWWWWWWLLLLLLLWLWWWLLLLWWWWWLLLLLLLWWWWWWWWWWWLWWWWWWWWWWWWWWLLLLLLLWWWWWWWLLLLWWWWWWWWWWWLW
WWWWWWWWLWWWWWWLLLLLLLWWWWWWLLLWWWLWWWLWLLLLWWWWWWLWWWWWWWWWWWWWWWWWWLLLLLLLLWWWWWWWLWWWWWWWWWLWWWWW
WWWWWWWLWWWWWWWLLLLLLLLWLWWWWWWWWWWWWWWWWLLLWWWWWWWWWWLLWWLWWWWWWWWWWLLLLLLLLWWWWWWWWWWWWWWWWLWWWWWW
WWWWWLWWWWWWWWWLLLLLLLLWLWWWWWWWWWWWWWLWWWLLWWWWWWWWWWWWWWWWWWWWWWWWWWLLLLLLLWWWLWWWLWWWWWWWWWWWWWWW
WWWWWWWWWWWWWWWWLLLLLLWWWWWWLWWWWWWWWWWWWWLWWWWWWWWWWWWWWWWWWWWWWWWWWWWLLLLLLWWWWWWWWWWWLWWWWWWWWWWW
WWWLLLWWWWWWWWWWLLLLLWWWWWWWWWWWWWWWLWWWWWWWWWWLLLLLWWLLLWWWWWWWWWWWWWWWLLLLWWWWWWWWWWWWWWWWWWWWWWWW
WLLLLLLWLWWWWWWWLLLLWWWWWWWWWWWWWWWWWWWWWLLWWWWLLLLLLLLLLLWWWWWWWWWWWWWWWWWWWWWWWWWWWWWWWWWWWWWWWWWW
WWWWWWWLLLWWWLWWWLLLWWWWWWWWWWWWWWWWWWWLLLLWWWWWLLWWWWLLLLLWWWWWWWWWWWWWWWWWWLWWWWWLWLWWWWWWWWWWWWWW
WWWWWWWLLLLWWWWWLLLLWWWWWWWWWWWWWWWWLWLLLLLWWWWWWWWWWWWLLLLLWWWWWWWWWWLWWWWWWWWWWWLLLLLLLLLWWWWWWWWW
WWWWWWWWLLWWWWWWWWLWWWWWWWWWLLWWWWWWWWLLLLLWWWWWWWWWWWWLLLLWWWWWWWWWWWWWWWWWWWWWWLLLLLLLLLLLWWWWWLLW
WWWWWWWWLWWWWWWWWWWWWWWWWWWLLLWWWWWWWWLLLLLWWWWWWWWWWWWWLLLWWWWWWWWWWWLWWWWWWWWWLLLLLLLLLLLLLLLLLLLW
WWWWLWLWWWWWWWWWWWWWWWWWWWLLLLWWWWWWWWLLLLLWWWLWWWWWWWWWWWWWWWWWWWWWWWWWWWWWWWWWWLLLLLLLWWWWLLLLLLLW
WWWWWWWWWLWWWWWWWWLLWWWWWLLLLLLWWWWWWWWLLLWWWWWWWWWWWWWWWWWWLWWWWWWWWWWWWWWWWWWWWWLLLWWWWWWWLLLLLLLW
WWWWWWWWWWWWWWWWWLLLLWWWLLLLLLLLWWWWWWWWLWWWWWWWWWWWWWWWWWWWWWLWWWWWWWWWWWWWWWWWWWWWWWWWWWWLLLLLLLWW
WWWWWWLWWWWWWWWWWLLLLLLLLLLLLLLLLLLWWWWWWWWWWWLWWWWWWWWWWWWWWWWLWWWLWWWWWWWWWWWWWWWWWWLLWWWLLLLLLWWW
WWWWWWWWWWWWWWLWWLLLLLLLLLLLLLLLLLLWWWWWWWWWLLWWWWWWWWWWWWWWWWWWWWWWWWWWWWWWWWWWWWWWWLLLLLLLLLLLWWWW
WWWWWWWWWWWWWLWWWWLLLLLLLLLLLLLLLLWWWWWWWWWLLLWLWLWWWWWWWWWWWWWLLWWLWWWWWWLLWWWWWWWWWLLLLLLLLLLLWWWW
WLWWWWWWWWWWLLLWWWWWLLLLLLLLLLLLLLWWWWWWWWWLLLLWWWWWWWWLWWLWWWWLLWWWWWWWWLLLWWWWWWWWWLLLLLLLLLLLWWWW
WWWLWWWWWWWLLLLWWWWWWWLLLLLLLLLLLWWWWWWWWWWLLLWLWWWWWWLWWWWWWWLLLLWWWWWWWLLWWWWWWWWWWLLLLLLLWWWWWWWW
WWWWWWWWWWWLLLLWWLWWWWLLLLLLLLLLWWWWWWWWWLWLLLWWWWWWWWWLWWWWWWLLLLWWWWWWWWWWWLWWWWWWWWWWWWWWWWWWWWLW
WWWLWWWWWWWLLLLWWWWWWWLLLLLLLLLWWWLWWWWWWWWLLLLWWWWWWWWWWWWWWWLLLLWWWWWWWWWWWWWWWWLWWWWWWWWWWWLWWLLW
WWWWWWWWWLWLLLWWWWWWWWLLLLLLLWWWWWWWWWWWWLLLLLLLWWWLLLWWWWWWWWWLLLWWWWWWWWWWWWWWWWWWWWWLWWWWWLWWWWLW
WWWWWWWWWWWWLWWWWWWWWWLLLLLLWWWWWWWWWLWWWWWLLLLLLLLLLLLWWWWWWWWWWWWWWWWWWWWWWWWWWWWWWWWWWLWWWWWWWWLW
WLWWWWWWWWWWWWWWWWWWWWLLLWWWWWWLWWWWWWWWWWWLLLLLLLLLLLLWWWWWWWWWWWWWWWWWWWWWWWWWWWWWWWWWWWWWWWLWWWWW
WWWWWWWWWWWWWWWWWLWWWWWWWWWWWWWWWWWWWWWWWWWLLLLLLLLLLLLWWWWWWWWWWLWWLWWWLLWWWWWWWWWWWWWWWWWWWWWWWWWW
WWWWWWWWWWWWWWWWWWWWWWWWWLWWWLWWWWWWLLLWWWWLLLLLLLLLLLLWWWWWWWWWWWWWWWWLLLLWWWWWWWWWWWWWWWWWWWWWWWWW
WWWWLWWWWLLLWWWWWWWWWWWWWWWWWWWWWWWLLLLWWWWLLLLLLLLLLLLWWWWWWWWWWWWWWWLLLLLWWWWWWWWWWWWLWWWWWWWWWWWW
WWWWWWWWLLLLLWWWWWLWWWWWWWWLWWWWWWLLLLLLWWWWWLLLLLLLLLLWWWWWWWWWWWWWWWLLLLLWWWWWWWWWWWWWWWWWWWWWWWLW
WWWWWWWLLLLLLWWWWWWWWWWWWWWWWWWWWWLLLLLLLWWWLWWLLLLLLLLWLLLWWWWWWWWWWLLLLLWWWWWWWWWLWWLWWWWWWWWWWWWW
WWWWWWLLLLLLLWWWWWWWWWWWWWWLWWWWWWLLLLLLLLWWWWWWLLLLLWWWLLLLWWWWWWLWWLLLLLLWWWWWWWWWWWWWWWWWWWWWWWWW
WWWWWWWLLLLLLWWWWWWWWWWWWWWWWWWWWWWLWLLLLLWWWWWWWLLLWWWWWLLLLWWWWWWWWLLLLLLLWWWWWWWWWWWWLLLLWWWWWWWW
WWWWWLWWWLLLLWWWWWWWWWWWWWWWWLLWWWWWWWWLLLWWWWWWWWWWLWWWWLLLLLWWWLWWWWLLLLLLLWWWWWWWWWWWLLLLLWWWWWWW
WWWWWWWLWWLLLLWWWWWWWWWWWWWWLLLLWWWWWWWWWWWWWWWWWWWWWWWWWWLLLLLWWWWWWWWLLLLLLWWWWLWWWWWWWLLLLLWWWWWW
WWWWWWWWWWWWLLLWWWWWWLWWWWWLLLLLWWWWWWWWWWWWLWWWWWWWWWWWWWLLLLLWWWWWWWWLLLLLLWWWWWWWWWWWWWLLLLLLLWWW
WWWWWWWWWWWWWWWWWWWWWWWWWWLLLLLLWWWWWWLWWLWWWWWLWWWWWWWWWWWLLLLWWWWWWWWWLLLLLWWWWWWWWWWWWWWLLLLLLLWW
WLWWWWWWWWWWWWWWLLWWWWLWWWLLLLLLWWWWWLWWWWWWWWWWWWWWWWWWWWWLLLLWWWWWWWWWLLLLWWWWWWWWWWWWWWLLLLLLLLWW
WWWWWWLWWWWWWWWWLLLWWWWWWWWLLLLLWWWLLWWWWWWWWWWWWWWWWWWWWWWLLLLWWWWWWWWWWLLLWWLWWWWWWWWWWWLLLLLLLLWW
WWWWWWWWWWWWWWWWWWWWWWWWWWWWWWWWWWWWWWWWWWWWWWWWWWWWWWWWWWWWWWWWWWWWWWWWWWWWWWWWWWWWWWWWWWWWWWWWWWWW
