WWWWWWWWWWWWWWWWWWWWWWWWWWWWWW
WWWWWWWWWWWWWWLLLWWWWWWWWWWWWW
WWLWWWWWWWWWWLLLLLLWWWWWWWWWWW
WWWWWWWWWWWWWLLLLLLWWWWWWWWWWW
WWWWWWWWWWWWLLLLLLLWWWWWWWWWWW
WWWWWWWWWWWWLLLLLLWWWWWLWWWWWW
WWWWWWWWWWWWWLLLLWWWWWWWWWWWWW
WWWWWWLWWWWWWLLLWWLWWWWWWWWWWW
WWWWWWWWWWWWLLLLWWWWWWWLWWWWWW
WWLWWWWWLWWWLLLLWLWWWWWWWWWWWW
WWWLWWWWWWWWLLLLWWWLWWWWWWWWLW
WWWLLLWWWWWLLLLLWLWWWWWWWWWLLW
WWWLLLLLWWWLLLLLWWWWWWWWWWWLLW
WWWLLLLLWWWWWLLLLWWLWWWWWLWWLW
WWWLLLLLWWWWWWLLLLLLLLWWWWWWWW
WWWWLLLWWWWWWWWLLLLLLLLWWWLWWW
WWWWLLLWWWWWWWWWWLLLLLWWWWWWWW
WWWWWWWWWWWWWWWWWWLLLLWWWWWWWW
WLLLLWWWWWWWWWWWLWWWLWWWWWWWWW
WLLLLLWWWWWWWLWWWWWWWWWWWWWWWW
WLLLLLLLWWWWWWWWWWWWWWWWWWWWWW
WLLLLLLLLLLWWWWWWWWWWWWWWWWWWW
WLLLLLLLLLLLWWWWWWWLWWWLLLLWLW
WLLLLLLLLLLLLWWWWWWWWWLLLLLLLW
WWWLLLLLLLLLWWWWWWWWWLLLLLLLLW
WWWWWLLLLLLLLWWWLWWWWLLLLLLLLW
WWWWLLLLLLLWWWWWWWWWWLLLLLLLLW
WWWLLLLLLLLWWWWWWWWWWWLLLLLLLW
WWWLLLLLLLLWWWWWWWWWWWWLLLLLWW
WWWWWWWWWWWWWWWWWWWWWWWWWWWWWW
