WWWWWWWWWWWWWWWWWWWWWWWWWWWWWW
WWWWWWLWWWWWWWWWLLLLWWWWWLWWWW
WWWWWWWWWWWWWWWWWWWWWWWWWWWWWW
WLWWWWWWWWWWWWWWWWWWWWWWWWWWWW
WWWWWWWWWWWWWLWWWWWWWWWWWWWWWW
WWWWWWWWWWWWWWWWWWWWWWWWWWWWWW
WWWWWWWWWWWWWLWWLWWWWWWWWWWWWW
WLWWWWWWWWLWWWWWWWWWWWWLLLLLWW
WLLWWWWWLWWLWWLWWWWWWWLLLLLLWW
WLLLWWWWWWWWWWWWWWWLWLLLLLLLLW
WLLLLLWWWWWWWLWWWWWWWLLLLLLLLW
WLLLLLLWWWWWWWWWWLWWWLLLLLLLLW
WLLLLLLWWWWWWWWWWWWWWLLLLLLLWW
WLLLLLLWWWWWWWWWWWWWWWLLLLWWWW
WLLLLLLWWWWWWWWWWWLWWWWWWWWWWW
WLLLLLLWWWWWWWWWLLWWWWWWWWWWWW
WLLWWWWWWWWWWWLLLLWWWWWWWWWWWW
WLWWWWWWWWWWWLLLLLWWWWWWLWWWWW
WLWWWWWWWWWWLLLLLWWWWWWWWWWWWW
WLWWWWWWWWLWWLLLWWWWWWWWWWWWWW
WLWWWWLWWWWWWWWLWWWWLWWWWWWWWW
WLWWWWWLLWWWWWWWWWWLWWWWWWWWWW
WLWWWWWWWWWWWWWWWWWWWWWWWWWWWW
WWLWWWWWWWWWWWWWWWWWWWWWWWWWWW
WWWWWWWWWWWWWWWWWWWWWWLLLWWWWW
WWWWWWWWLLLWLWWWWWWWWWLLLLWWWW
WWWWWWWLLLLLWWWWWWWWWWLLLLLLWW
WWWWWWWLLLLLWWWWWWWWWWWLLLLLLW
WWWWWWWWLLLLWWWWWWWWWWWWLLLLLW
WWWWWWWWWWWWWWWWWWWWWWWWWWWWWW
